R 2000 900

NO ./textures/wall_1.xpm
SO ./textures/wall_2.xpm
WE ./textures/west.xpm
EA ./textures/east.xpm
S ./textures/pillar.xpm

F 220,100,0

C 29,145,246

1111111111111111111111111111111111111111111111
1210001100000000010001011000010100001111121111
1000100001111101110100000011000001101110000001
1110111011011101010111101111101011111010111011
1100010011000100000001001110100010000000111001
1101011000010111111011011000001110110110011011
1101001111010000011001001010111100011111110011
1001100000011111011101100010000111011000110111
1011001101000000000101111110110000000010110001
1011011001111111110100000000111101110110000111
1001000011110000010111101011110100111111011111
1101111110000111010000001000000111111100001111
1100001000111100011111211101110000111110111011
1111100010101001000001N00000110110000100000011
1110111110001011101101101011110111101111101001
1100010200111001101111101000111110000110001011
1001000111111011000110001110001010111111011011
1101111111000001101111011110111000000111010001
1100000000011101001100211000111011111100011111
1111011101110000011101001011100000001101110011
1110010001111011111001111000110110100100000111
1110111011010000011011110010110000110111101101
1120001000000111000000011110011011100001000021
1111111111111111111111111111111111111111111111
