R 2000 900

NO ./textures/north.xpm
SO ./textures/wall_2.xpm
WE ./textures/west.xpm
EA ./textures/east.xpm
S ./textures/pillar.xpm

F 220,100,0

C 29,145,246

11111111111111111111111111111
10000000001100000000000000001
10110000011100000000002010001
10010000000000000000200010001
10110000011100000000000010001
10000000001100000111011110201
11110111111111011100000012001
11110111111111011101010010001
11000000110101011100000010001
10000000000000001100000010201
10000000000000001101010010001
11000000110101011111011110N01
11110111111101011111011110001
11111111111111111111111111111
