R 800 600
NO ./textures/north.xpm
SO ./textures/wall_2.xpm
WE ./textures/west.xpm
EA ./textures/east.xpm
S ./textures/enemy.xpm
F 40,12,0
C 29,145,246
11111
10201
10N01
10001
11111
