R 800 600

NO ./textures/north.xpm
SO ./textures/wall_2.xpm
WE ./textures/west.xpm
EA ./textures/east.xpm
S ./textures/enemy.xpm

F 40,12,0
C 29,145,246

1 1 1 1 1 1 1 1 1 1 1 1 1 1 1 1
1 0 0 0 0 0 0 0 0 0 0 0 0 0 0 1
1 0 1 0 2 0 0 0 0 1 0 1 0 1 0 1
1 0 0 0 0 0 0 0 1 0 1 0 1 0 1 1
1 0 0 0 W 0 0 0 0 0 0 1 1 0 1 1
1 0 1 0 0 0 0 0 0 0 0 0 0 0 0 1
1 0 0 0 2 0 0 0 0 0 0 1 1 1 1 1
1 1 1 1 1 1 1 1 1 1 1 1 1 1 1 1
